[
  [ -1, -1, -1, -1, -1, -1, -1, -1, -1, 32, 33, 33, 34,  5,  6, 16, 17, 17, 17, 17, 17, 17, 17, 17, 17, 33, 33, 33, 33, 33, 34,  5,  6, 16, 17, 17, 17, 17, 17, 17, 17, 17, 17, 33, 33, 33, 33, 33, 34,  5,  6, 16, 17, 17, 17, 17, 17, 17, 17, 17, 17, 33, 33, 33, 33, 33, 34,  5,  6, 16, 17, 17, 17, 17, 17, 17, 17, 17, 17, 33, 33 ],
  [ -1, -1, -1, -1, -1, -1, -1, -1, -1, -1, -1, -1, -1, 21, 22, 32, 33, 33, 34,  5,  6, 16, 17, 17, 18,  5,  6, -1, -1, -1, -1, 21, 22, 32, 33, 33, 34,  5,  6, 16, 17, 17, 18,  5,  6, -1, -1, -1, -1, 21, 22, 32, 33, 33, 34,  5,  6, 16, 17, 17, 18,  5,  6, -1, -1, -1, -1, 21, 22, 32, 33, 33, 34,  5,  6, 16, 17, 17, 18,  5,  6 ],
  [ -1, -1, -1, -1, -1, -1, -1, -1, -1, -1, -1, -1, -1, 37, 38, -1, -1, -1, -1, 21, 22, 32, 33, 33, 34, 21, 22, -1, -1, -1, -1, 37, 38, -1, -1, -1, -1, 21, 22, 32, 33, 33, 34, 21, 22, -1, -1, -1, -1, 37, 38, -1, -1, -1, -1, 21, 22, 32, 33, 33, 34, 21, 22, -1, -1, -1, -1, 37, 38, -1, -1, -1, -1, 21, 22, 32, 33, 33, 34, 21, 22 ],
  [ -1, -1, -1, -1, -1, -1, -1, -1, -1, -1, -1, -1, -1, 53, 54, -1, -1, -1, -1, 37, 38, -1, -1, -1, -1, 37, 38, -1, -1, -1, -1, 53, 54, -1, -1, -1, -1, 37, 38, -1, -1, -1, -1, 37, 38, -1, -1, -1, -1, 53, 54, -1, -1, -1, -1, 37, 38, -1, -1, -1, -1, 37, 38, -1, -1, -1, -1, 53, 54, -1, -1, -1, -1, 37, 38, -1, -1, -1, -1, 37, 38 ],
  [ -1, -1, -1, -1, -1, -1, -1, -1, -1, -1, -1, -1, -1, -1, -1, -1, -1, -1, -1, 21, 22, -1, -1, -1, -1, 53, 54, -1, -1, -1, -1, -1, -1, -1, -1, -1, -1, 21, 22, -1, -1, -1, -1, 53, 54, -1, -1, -1, -1, -1, -1, -1, -1, -1, -1, 21, 22, -1, -1, -1, -1, 53, 54, -1, -1, -1, -1, -1, -1, -1, -1, -1, -1, 21, 22, -1, -1, -1, -1, 53, 54 ],
  [ -1, -1, -1, -1, -1, -1, -1, -1, -1, -1, -1, -1, -1, -1, -1, -1, -1, -1, -1, 53, 54, -1, -1, -1, -1, -1, -1, -1, -1, -1, -1, -1, -1, -1, -1, -1, -1, 53, 54, -1, -1, -1, -1, -1, -1, -1, -1, -1, -1, -1, -1, -1, -1, -1, -1, 53, 54, -1, -1, -1, -1, -1, -1, -1, -1, -1, -1, -1, -1, -1, -1, -1, -1, 53, 54, -1, -1, -1, -1, -1, -1 ],
  [ -1, -1, -1, -1, -1, -1, -1, -1, -1, -1, -1, -1, -1, -1, -1, -1, -1, -1, -1, -1, -1, -1, -1, -1, -1, -1, -1, -1, -1, -1, -1, -1, -1, -1, -1, -1, -1, -1, -1, -1, -1, -1, -1, -1, -1, -1, -1, -1, -1, -1, -1, -1, -1, -1, -1, -1, -1, -1, -1, -1, -1, -1, -1, -1, -1, -1, -1, -1, -1, -1, -1, -1, -1, -1, -1, -1, -1, -1, -1, -1, -1 ],
  [ -1, -1, -1, -1, -1, -1, -1, -1, -1, -1, -1, -1, -1, -1, -1, -1, -1, -1, -1, -1, -1, -1, -1, -1, -1, -1, -1, -1, -1, -1, -1, -1, -1, -1, -1, -1, -1, -1, -1, -1, -1, -1, -1, -1, -1, -1, -1, -1, -1, -1, -1, -1, -1, -1, -1, -1, -1, -1, -1, -1, -1, -1, -1, -1, -1, -1, -1, -1, -1, -1, -1, -1, -1, -1, -1, -1, -1, -1, -1, -1, -1 ],
  [ -1, -1, -1, -1, -1, -1, -1, -1, -1, -1, -1, -1, -1,  3,  4, -1, -1, -1, -1, -1, -1, -1, -1, -1, -1, -1, -1, -1, -1, -1, -1,  3,  4, -1, -1, -1, -1, -1, -1, -1, -1, -1, -1, -1, -1, -1, -1, -1, -1,  3,  4, -1, -1, -1, -1, -1, -1, -1, -1, -1, -1, -1, -1, -1, -1, -1, -1,  3,  4, -1, -1, -1, -1, -1, -1, -1, -1, -1, -1, -1, -1 ],
  [ -1, -1, -1, -1, -1, -1, -1, -1, -1, -1, -1, -1, -1, 35, 36, -1, -1, -1, -1, -1, -1, -1, -1, -1, -1,  3,  4, -1, -1, -1, -1, 35, 36, -1, -1, -1, -1, -1, -1, -1, -1, -1, -1,  3,  4, -1, -1, -1, -1, 35, 36, -1, -1, -1, -1, -1, -1, -1, -1, -1, -1,  3,  4, -1, -1, -1, -1, 35, 36, -1, -1, -1, -1, -1, -1, -1, -1, -1, -1,  3,  4 ],
  [ -1, -1, -1, -1, -1, -1, -1, -1, -1, -1, -1, -1, -1, 51, 52, -1, -1, -1, -1, 19, 20, -1,  0,  1,  2, 51, 52, -1, -1, -1, -1, 51, 52, -1, -1, -1, -1, 19, 20, -1,  0,  1,  2, 51, 52, -1, -1, -1, -1, 51, 52, -1, -1, -1, -1, 19, 20, -1,  0,  1,  2, 51, 52, -1, -1, -1, -1, 51, 52, -1, -1, -1, -1, 19, 20, -1,  0,  1,  2, 51, 52 ],
  [ -1, -1, -1, -1, -1, -1, -1, -1, -1,  0,  1,  1,  2, 67, 68,  0,  1,  1,  2, 67, 68,  0, 17, 17, 18, 67, 68,  0,  1,  1,  2, 67, 68,  0,  1,  1,  2, 67, 68,  0, 17, 17, 18, 67, 68,  0,  1,  1,  2, 67, 68,  0,  1,  1,  2, 67, 68,  0, 17, 17, 18, 67, 68,  0,  1,  1,  2, 67, 68,  0,  1,  1,  2, 67, 68,  0, 17, 17, 18, 67, 68 ]
]
